XXXXXXXXXX
X        X
X  X   b X
X aX     X
XXXX     X
X        X
X   A XXXX
X     Xc X
X d      X
XXXXXXXXXX